RH_ASK	KEYWORD1
init	KEYWORD2
available	KEYWORD2
recv	KEYWORD2
send	KEYWORD2
maxMessageLength	KEYWORD2
setModeIdle	KEYWORD2
setModeRx	KEYWORD2
setModeTx	KEYWORD2
handleTimerInterrupt	KEYWORD2
waitPacketSent	KEYWORD2
RHcrc16_update	KEYWORD2
RHcrc_xmodem_update	KEYWORD2
RHcrc_ccitt_update	KEYWORD2
RHcrc_ibutton_update	KEYWORD2
RHDatagram	KEYWORD1
setThisAddress	KEYWORD2
sendto	KEYWORD2
recvfrom	KEYWORD2
waitAvailable	KEYWORD2
waitAvailableTimeout	KEYWORD2
setHeaderTo	KEYWORD2
setHeaderFrom	KEYWORD2
setHeaderId	KEYWORD2
setHeaderFlags	KEYWORD2
headerTo	KEYWORD2
headerFrom	KEYWORD2
headerId	KEYWORD2
headerFlags	KEYWORD2
thisAddress	KEYWORD2
RHGenericDriver	KEYWORD1
RHMode	KEYWORD1
setPromiscuous	KEYWORD2
lastRssi	KEYWORD2
mode	KEYWORD2
setMode	KEYWORD2
printBuffer	KEYWORD2
rxBad	KEYWORD2
rxGood	KEYWORD2
RHGenericSPI	KEYWORD1
transfer	KEYWORD2
attachInterrupt	KEYWORD2
detachInterrupt	KEYWORD2
begin	KEYWORD2
end	KEYWORD2
setBitOrder	KEYWORD2
setDataMode	KEYWORD2
setFrequency	KEYWORD2
RHHardwareSPI	KEYWORD1
RHMesh	KEYWORD1
sendtoWait	KEYWORD2
recvfromAck	KEYWORD2
recvFromAckTimeout	KEYWORD2
RH_NRF24	KEYWORD1
spiReadRegister	KEYWORD2
spiWriteRegister	KEYWORD2
spiBurstReadRegister	KEYWORD2
spiBurstWriteRegister	KEYWORD2
statusRead	KEYWORD2
setChannel	KEYWORD2
setOpMode	KEYWORD2
setNetworkAddress	KEYWORD2
setRF	KEYWORD2
isSending	KEYWORD2
printRegisters	KEYWORD2
RH_NRF905	KEYWORD1
RHNRFSPIDriver	KEYWORD1
spiCommand	KEYWORD2
spiRead	KEYWORD2
spiWrite	KEYWORD2
spiBurstRead	KEYWORD2
spiBurstWrite	KEYWORD2
RHReliableDatagram	KEYWORD1
setRetries	KEYWORD2
retries	KEYWORD2
retransmissions	KEYWORD2
resetRetransmissions	KEYWORD2
RH_RF22	KEYWORD1
reset	KEYWORD2
adcRead	KEYWORD2
temperatureRead	KEYWORD2
wutRead	KEYWORD2
setWutPeriod	KEYWORD2
setFHStepSize	KEYWORD2
setFHChannel	KEYWORD2
rssiRead	KEYWORD2
ezmacStatusRead	KEYWORD2
setTxPower	KEYWORD2
setModemRegisters	KEYWORD2
setModemConfig	KEYWORD2
setPreambleLength	KEYWORD2
setSyncWords	KEYWORD2
setCRCPolynominal	KEYWORD2
setGpioReversed	KEYWORD2
getLastPreambleTime KEYWORD2
RH_RF24	KEYWORD2
setIdleMode	KEYWORD2
command	KEYWORD2
set_properties	KEYWORD2
get_temperature	KEYWORD2
get_battery_voltage	KEYWORD2
get_gpio_voltage	KEYWORD2
frr_read	KEYWORD2
RH_RF69	KEYWORD1
setEncryptionKey	KEYWORD2
getLastPreambleTime	KEYWORD2
RH_RF95	KEYWORD1
RHRouter	KEYWORD1
setMaxHops	KEYWORD2
addRouteTo	KEYWORD2
getRouteTo	KEYWORD2
deleteRouteTo	KEYWORD2
retireOldestRoute	KEYWORD2
clearRoutingTable	KEYWORD2
printRoutingTable	KEYWORD2
sendtoFromSourceWait	KEYWORD2
RH_Serial	KEYWORD1
RHSoftwareSPI	KEYWORD1
setPins	KEYWORD2
RHSPIDriver	KEYWORD1
RH_TCP	KEYWORD1
